18 10
XXXXXXXXXX
X||+||#||X
X|XXXXXX|X
XXXXXXXXXX
X||+||#||X
X|XXXXXX|X
XXXXXXXXXX
X||+||#||X
X|XXXXXX|X
XXXXXXXXXX
X--#-----X
X-----#--X
XXXXXXXXXX
X...|#|-.X
X|+||.||.X
XXXXXXXXXX
X-.+#|-.+X
XXXXXXXXXX
6
X 1 1 W |
C 1 4 W |
T 1 7 W |
H 1 10 W -
B 1 13 W |
A 1 16 W -